##########
#........#
#....S...#
#..T.....#
#........#
##########