#####################
#...............#..E#
#.#####.#####.###.###
#.....#.....#.....#.#
###.#.###.#.#####.#.#
#...#.....#.....#...#
#.#########.###.#####
#...........#.......#
#.###########.#######
#.....#.....#.......#
#####.#.###.#####.#.#
#.....#...#.....#.#.#
#.#########.###.#.#.#
#...............#...#
#####################