#####################
#....T..............#
#.#####.###########.#
#.....#.....#.......#
###.#.###.#.#.#####.#
#...#...#.#.#.....#.#
#.###.#.#.#.###.#.#.#
#.....#...#...#.#...#
#.###########.#.###.#
#.............#...#.#
#.###############.#.#
#.....#...........#.#
#.###.#.###########.#
#...#.............E.#
#####################