#####################
#..B....#....I....#E#
#.#####.#.#######.#.#
#.....#.#.....T...#.#
###.#.#.###.#####.#.#
#...#.#...#.....#.#.#
#.###.###.#.###.#.#.#
#...#.....#.#...#...#
#.#.#######.#.#####.#
#.#.....S...#.....#.#
#.#####.#########.#.#
#A....#.....R....#..#
#####.#.########.##.#
#Z..L.#.....B....#..#
#####################