#####################
#A....#.....I......E#
#.###.#.###########.#
#...#.#.....#.......#
###.#.###.#.#.#####.#
#...#...#.#.#.....#.#
#.###.#.#.#.###.#.#.#
#.....#...#...#.#...#
#.###########.#.###.#
#.....S.......#...#.#
#.#####.#######.#.#.#
#.....#.....B...#.#.#
#.###.#.#####.###.#.#
#Z....#.....L.....#.#
#####################