#####################
#..B.............E..#
#.#####.###########.#
#.....#.....#.......#
###.#.###.#.#.#####.#
#...#...#.#.#.....#.#
#.###.#.#.#.###.#.#.#
#.....#...#...#.#...#
#.###########.#.###.#
#.....L.......#...#.#
#.#####.#######.#.#.#
#.....#.....B...#.#.#
#.###.#.#########.#.#
#..L..#...........#.#
#####################