#####################
#....I.......S....E.#
#.#####.###########.#
#.....#.....#.......#
###.#.###.#.#.#####.#
#...#...#.#.#.....#.#
#.###.#.#.#.###.#.#.#
#.....#...#...#.#...#
#.###########.#.###.#
#.....I.......#...#.#
#.#####.#######.#.#.#
#...S.#.....I...#.#.#
#.###.#.#########.#.#
#.....#...........#.#
#####################