#####################
#.......#.....R....E#
#.#####...###########
#.....#.#.....#.....#
###.#.#.###.#.#.###.#
#...#.#...#.#.#...#.#
#.###.###.#.#.###.#.#
#.....#...#.#...#.#.#
#.#####.###.###.#.#.#
#.....#.....#...#...#
###.#.#######.#####.#
#...#.....R...#.....#
#.#######.#####.###.#
#...............#...#
#####################