#####################
#..I..#.....T....#E.#
#.###.#.########.#.##
#...#.#.....#....#..#
###.#.###.#.#.#####.#
#...#.....#.#.....#.#
#.#####.###.###.#.#.#
#.....#...#...#.#...#
#.###.###.#.#.#.###.#
#R..#...#.#.#.#...#.#
###.#.#.#.#.#.###.#.#
#...#.#...#.#.....#.#
#.###.#####.#####.#.#
#A..S....B....L..Z..#
#####################