#####################
#..B..#....I....#..E#
#.###.#.#####.###.###
#...#.#...T.#.....#.#
###.#.###.#.#####.#.#
#...#...#.#...R.#...#
#.###.#.#.###.#.#####
#A....#...#...#.....#
#####.#####.#######.#
#.....S.....#.....#.#
#.###########.###.#.#
#.....#.....#...#.#.#
#.###.#.###.###.#.#.#
#Z..L.#..B......#...#
#####################